*********************
* *   *       *     *
* * * * *** *** * ***
* * * * *   *   *   *
* * * * * * * ***** *
*H  *   * * * *   * *
***** *** *** * * * *
*   *   *   *   * * *
* * ******* * ***** *
* *         * *     *
* ***** ***** * *****
*   *   *     * *   *
*** ***** ***** * * *
*   *     *   *   * *
* * * ***** * ***** *
* * * * *   *   *   *
* *** * * ***** * ***
*       * *     *   *
********* * ******* *
*         *         *
*************E*******
