***********
*         E
* *** * * *
* * * * * *
* * * *** *
* *      H*
***********
