***************
*     *       E
*** * * ***** *
*   *   *   * *
* ********* * *
*H*   *     * *
* * * * ***** *
*   * * *     *
* *** * * *****
* *   * * *   *
* * *** * * * *
* * * *   * * *
*** * * *** * *
*   *       * *
***************
